-5:-4: 0:-5:-5:-4:-5:-5:-5:-5
-4:-3: 0:-1:-1:-2:-2:-3:-4:-5
-3:-2: 0: 0: 0:-2: 0: 0: 0: 0
-1:-1:-1: 0: 0:-1: 0:-1:-1:-1
 0: 0: 0:-1: 0:-1: 0:-1: 0:+1
-1:-1: 0:-1: 0:-1: 0:-1: 0:-1
-1:-1: 0: 0: 0:-1: 0: 0: 0: 0
-3:-2:-2:-1: 0:-1: 0:-1: 0:-4
-4:-5:-4:-1: 0: 0: 0:-5: 0:-5
-5:-5:-3:-2:-2:-1:-4:-5:-5:-5